####################
#  #WW##WWWW##WW#  #
# WWWWWW#WW#WWWWWW #
#W#WWWW#W##W#WWWW#W#
#WWW#WW#W##W#WW#WWW#
#WWWWW#WWWWWW#WWWWW#
#WWW##WWWWWWWW##WWW#
##WWWWWWWWWWWWWWWW##
#WW#WWWWW##WWWWW#WW#
#WWW#WW#WWWW#WW#WWW#
#WWW#WW#WWWW#WW#WWW#
#WW#WWWWW##WWWWW#WW#
##WWWWWWWWWWWWWWWW##
#WWW##WWWWWWWW##WWW#
#WWWWW#WWWWWW#WWWWW#
#WWW#WW#W##W#WW#WWW#
#W#WWWW#W##W#WWWW#W#
# WWWWWW#WW#WWWWWW #
#  #WW##WWWW##WW#  #
####################
